Bohemian Rhapsody - Queen
Stairway to Heaven - Led Zeppelin
Imagine - John Lennon
Smells Like Teen Spirit - Nirvana
One - Metallica
Comfortably Numb - Pink Floyd
Hotel California - Eagles
Hey Jude - The Beatles
Back Door - Stray Kids
7 Summers - Morgan Wallen
Think About Things - Daoi Freyr
Good News - Mac Miller
Little Nokia - Bree Runway
Yo Perreo Sola - remix Bad Bunny Ivy Queen and Nesi
WAP - Cardi B feat. Megan Thee Stallion
People I've Been Sad - Christine and the Queens
God's Plan - Drake
One Kiss - Dua Lipa
Peaches - Justin Bieber 
RAPSTAR - Polo G
Astronaut in the Ocean - Masked Wolf 
Kiss Me More - Doja Cat 
Levitating - Dua Lipa
Leave The Door Open - Bruno Mars 
Deja vu - Olivia Rodrigo 
Fiel - Los Legendarios
Save You Tears - The Weekend
DAKITI - Bad Bunny 
Telepatía - Kali Uchis
The Business - Tiësto
Hold On - Justin Bieber
Runaway - AURORA
UP - Cardi B
Mood - 24kGoldn
Without you - The Kid Laroi 
Bandido - Myke Towers 
Arcade - Duncan Laurence
Streets - Doja Cat 
Calling My Phone - Lil Tjay 
SOLID - Young Stoner Life 
911 - Sech 
Heat Waves - Glass Animals 
Your Love - ATB 
Watermelon Sugar - Harry Styles 
LA NOCHE DE ANOCHE - Bad Bunny 
Dynamite - BTS 
Goosebumps Remix - Travis Scott 
Beautiful Mistakes - Maroon 5
Someone You Loved - Lewis Capaldi 
Don't Start Now - Dua Lipa 
Baila Conmigo - Selena Gomez 
Anyone - Justin Bieber 
Ella No Es Tuya Remix - Rochy RD 
Head & Heart - Joel Corry 
Best Friend - Saweetie 
Good Days - SZA 
Positions - Ariana Grande 
Lemonade - Internet Money 
Hecha pa' mi - Boza 
Paradise - MEDUZA 
Vida de Rico - Camilo 
Ay diOs Mío! - Karol G 
Botella tras botella - Cristian Nodal 
Mi Cuarto - Jerry Di 
Machu Picchu - Camilo 
COMO SE SIENTE REMIX - Jhay Cortez 
LA CANCION - Bad Bunny 
LOCATION - Karol G 
UN DIA (ONE DAY) - J Balvin 
Chica Ideal - Sebastián Yatra 
La Curiosidad - Jay Wheeler 
BICHOTA - Karol G 
Reloj - Rauw Alejandro 
Naturaleza - Anuel AA 
Safe And Sound - Capital Cities 
Life Is Life - Opus 
Rock DJ - Robbie Williams 
Little Talks - Of Monster and Men 
Fireflies - Owl City 
You - Benny Blanco 
Redbone - Childish Gambino 
I Don't Wanna Live Forever 
Three Little Birds - Bob Marley & The Wailers 
Good Old Days - Macklemore 
Foreplay - Jalen Santoy 
Hands in the Fire - James Carter 
Beautiful - Cristina Aguilera 
Devil Eyes - Hippie Sabotage 
Be Alright - Dean Lewis 
Let it be me - David Guetta 
Dancing in my room - 347aidan 
Don't you worry child - Swedish House Mafia 
Burning Love - Elvis Presley 
Infinity - Olamide 
Fine Line - Harry Styles 
Flashed Junk Mind - Milky Chance 
Stolen Dance - Milky Chance 
Wonder - Shawn Mendes 
Loud Places - Jamie xx 
Spirits - The Strumbellas 
Summer - Calvin Harris
Bedroom - Litany 
What they want - Russ 
My future - Billie Eilish 
Glad You Came - The Wanted 
OK - Robin Schulz 
Toosie Slide - Drake 
Mama Said - Lukas Graham 
Sunday Best - Surfaces 
Bring My Baby Back - OMI 
Dance with me - Diplo 
Lose Somebody - Kygo 
Best Friend - Rex Orange County 
Island in the sun - GAMPER&DADONI 
Happiest Man on Earth - Broken Back 
Down Under - Men at Work 
It's Time - Imagine Dragons 
Enough to Believe - Bob Moses 
Summer Paradise - Simple Plan 
I Like Me Better - Lauv
Goodbye - Jason Derulo 
Wake Me Up - Avicii 
Shotgun - George Ezra 
Blow That Smoke - Major Lazer
Lucky You - Eminem 
The Nights - Avicii
It Ain't Me - Kygo 
Space - Capital Cities 
Magic in the Hamptons - Social House 
Whatever you like - T.I. 
Home - Phillip Phillips
Something New - Faul 
LOVE - Gianluca Vacchi 
Say Something - Justin Timberlake 
Living - Bakermat 
The Middle - Zedd 
Dancer - Flo rida 
The Plan - Wiz Khalifa 
Psycho - Post Malone 
These Days - Rudimental 
Sun Goes Down - Robin Schulz 
Klanga - Gostan 
The Ocean - Mike Perry 
Catch & Release - Matt Simons 
Boulevard of Broken Dreams - Green Day 
Sick Boy - The Chainsmokers 
Ride - Twenty One Pilots 
Pursuit of Happiness - Kid Cudi 
Follow You - Cheat Codes 
Royals - Lorde 
Stronger - Kanye West 
I'm the one - DJ Khaled 
Sorry - Justin Bieber 
Young, Wild and Free - Snoop Dogg
Stay With Me - Sam Smith 
Thrift Shop - Macklemore
Messin' Around - Pitbull 
Free- Rudimental 
Hey, Soul Sister - Train 
I'm Yours - Jason Mraz 
Locked Out of Heaven - Bruno Mars 
Fast Car - Jonas Blue 
Pompeii - Bastille 
Omen - Disclosure 
The Show Goes On - Lupe Fiasco 
Cake By the Ocean - DNCE 
One Day - Matisyahu 
No Lie - Sean Paul 
Aloha - Møme
Millionaire - Digital Farm Animals 
Palmtree - Mandlebarth 
Hymn for the weekend - Coldplay 
Compliment you Soul - Dan Croll 
How to Save a Life - The Fray 
Let me love you - Justin Bieber
Ocean Drive - Duke Dumont 
Cheap Thrills - Sia 
Middle - DJ Snake 
Faded - Alan Walker 
I took a pill in Ibiza - Mike Posner 
Seve - Tez Cadey 
We Wanna - Alexandra Stan 
Lush Life - Zara Larsson 
Are You With Me - Lost Frequencies 
The Best Day of My Life - This Is Gonna Be Great 
Magnets - Disclosure
Locked Away - R. City 
Counting Stars - One Republic 
Sweat - Inner Circle 
Pumped Up Kicks - Foster The People 
See You Again - Wiz Khalifa 
Sexual Healing - Marvin Gaye 
Hall of Fame - The Script 
Snow - Red Hot Chili Peppers 
Punga - Klingande 
Uchi Wala - Maffio 
Calçots & Mangos - Taburete 
My Type - Saint Motel 
Cumbiana Remix - Carlos Vives
Uno - Rex Orange County
